Area,0 to 15,16 to 64,65 to 84,85 and over,Total
E92000001,10637971,34950948,8678455,1352056,55619430
E12000009,977522,3370820,1040367,170607,5559316
E01015023,369,1094,223,57,1743
E01015024,197,965,252,17,1431
E01015025,225,850,496,88,1659
E01015026,354,1018,185,31,1588
E01015027,293,1037,302,37,1669
E01015028,331,872,184,23,1410
E01015029,473,1106,225,25,1829
E01015030,371,1040,246,41,1698
E01015031,193,1020,171,71,1455
E01015032,165,1679,119,22,1985
E01015033,272,944,295,54,1565
E01015034,232,799,303,99,1433
E01015035,246,931,279,29,1485
E01015036,288,850,319,91,1548
E01015037,272,879,309,28,1488
E01015038,318,1101,293,42,1754
E01015039,250,1437,125,14,1826
E01015040,387,975,181,15,1558
E01015041,300,1036,178,12,1526
E01015042,300,998,163,5,1466
E01015043,358,1025,118,14,1515
E01015044,196,1028,187,32,1443
E01015045,328,1076,125,33,1562
E01015046,447,1205,255,20,1927
E01015047,481,1183,240,13,1917
E01015048,499,1461,182,12,2154
E01015049,119,1338,106,17,1580
E01015050,76,1780,105,30,1991
E01015051,81,1566,132,18,1797
E01015052,190,1657,106,22,1975
E01015053,113,1207,91,8,1419
E01015054,72,1740,79,14,1905
E01015055,277,914,207,32,1430
E01015056,249,1008,294,53,1604
E01015057,389,977,188,52,1606
E01015058,388,986,171,12,1557
E01015059,319,1136,179,15,1649
E01015060,316,992,255,14,1577
E01015061,297,1078,131,22,1528
E01015062,207,1757,119,20,2103
E01015063,321,943,228,34,1526
E01015064,213,880,441,81,1615
E01015065,289,706,321,51,1367
E01015066,219,826,297,24,1366
E01015067,188,783,396,74,1441
E01015068,326,959,310,40,1635
E01015069,339,935,221,28,1523
E01015070,539,1688,328,38,2593
E01015071,298,897,310,45,1550
E01015072,339,1026,200,23,1588
E01015073,282,967,228,30,1507
E01015074,322,907,279,36,1544
E01015075,291,853,252,22,1418
E01015076,265,898,231,38,1432
E01015077,500,1449,311,82,2342
E01015078,392,1018,224,24,1658
E01015079,351,1016,331,45,1743
E01015080,232,578,88,6,904
E01015081,349,946,235,37,1567
E01015082,326,1082,301,40,1749
E01015083,261,926,263,43,1493
E01015084,249,838,290,44,1421
E01015085,281,910,330,52,1573
E01015086,230,742,283,38,1293
E01015087,416,1033,188,19,1656
E01015088,498,1001,138,16,1653
E01015089,293,998,352,69,1712
E01015090,225,791,273,30,1319
E01015091,201,843,379,38,1461
E01015092,333,1393,228,36,1990
E01015093,244,826,297,17,1384
E01015094,284,779,277,49,1389
E01015095,195,739,411,25,1370
E01015096,256,851,291,20,1418
E01015097,202,1039,680,86,2007
E01015098,369,1099,224,39,1731
E01015099,274,1029,175,20,1498
E01015100,266,1071,156,22,1515
E01015101,296,887,363,144,1690
E01015102,341,1171,238,35,1785
E01015103,283,1022,161,20,1486
E01015104,320,960,236,40,1556
E01015105,270,976,174,35,1455
E01015106,222,756,243,36,1257
E01015107,361,1001,154,10,1526
E01015108,463,1076,244,21,1804
E01015109,201,989,207,8,1405
E01015110,284,977,273,18,1552
E01015111,351,1091,161,17,1620
E01015112,317,926,256,45,1544
E01015113,274,889,331,48,1542
E01015114,256,845,281,45,1427
E01015115,197,761,325,117,1400
E01015116,274,866,309,36,1485
E01015117,241,904,274,16,1435
E01015118,310,916,300,56,1582
E01015119,372,1057,231,9,1669
E01015120,282,959,354,44,1639
E01015121,243,744,433,41,1461
E01015122,301,917,325,71,1614
E01015123,214,878,481,175,1748
E01015124,251,824,372,85,1532
E01015125,256,841,358,34,1489
E01015126,224,668,452,129,1473
E01015127,217,804,385,77,1483
E01015128,224,914,427,56,1621
E01015129,287,909,155,27,1378
E01015130,346,1000,246,14,1606
E01015131,207,719,485,95,1506
E01015132,249,829,352,75,1505
E01015133,217,782,400,68,1467
E01015134,277,861,304,87,1529
E01015135,430,1198,296,49,1973
E01015136,245,916,280,42,1483
E01015137,336,1020,285,33,1674
E01015138,317,1020,459,38,1834
E01015139,270,773,295,82,1420
E01015140,273,696,398,73,1440
E01015141,316,899,484,53,1752
E01015142,283,900,234,26,1443
E01015143,201,786,285,33,1305
E01015144,367,998,186,28,1579
E01015145,692,1118,57,7,1874
E01015146,561,1307,142,5,2015
E01015147,209,698,295,42,1244
E01015148,294,1001,223,20,1538
E01015149,332,895,219,32,1478
E01015150,224,871,309,46,1450
E01015151,247,1371,128,16,1762
E01015152,390,1389,239,21,2039
E01015153,370,1221,226,44,1861
E01015155,407,1325,162,14,1908
E01015156,103,1465,218,10,1796
E01015157,260,1750,351,86,2447
E01015158,234,1739,438,86,2497
E01015159,258,892,371,52,1573
E01015160,218,832,396,69,1515
E01015161,282,813,292,16,1403
E01015162,297,930,223,59,1509
E01015163,249,790,351,46,1436
E01015164,480,1203,221,20,1924
E01015165,428,1060,185,25,1698
E01015166,536,1400,283,22,2241
E01015167,270,1135,151,21,1577
E01015168,314,1267,191,11,1783
E01015169,204,1357,253,58,1872
E01015170,332,1048,220,52,1652
E01015171,198,1140,264,84,1686
E01015172,289,1298,202,22,1811
E01015173,285,1151,265,64,1765
E01015174,271,1151,279,29,1730
E01015175,258,1205,160,28,1651
E01015176,235,910,225,28,1398
E01015177,278,1213,174,24,1689
E01015178,278,1622,132,25,2057
E01015179,198,1362,93,32,1685
E01015180,410,1220,227,22,1879
E01015181,371,1480,200,23,2074
E01015182,425,1327,190,31,1973
E01015183,200,739,347,60,1346
E01015184,119,541,548,87,1295
E01015185,154,715,380,53,1302
E01015186,206,798,347,26,1377
E01015187,175,674,538,90,1477
E01015188,213,762,501,59,1535
E01015189,155,672,286,23,1136
E01015190,317,912,392,32,1653
E01015191,331,1067,288,28,1714
E01015192,377,919,242,25,1563
E01015193,229,720,295,28,1272
E01015194,271,849,283,15,1418
E01015195,525,1247,320,41,2133
E01015196,564,1035,166,35,1800
E01015197,154,682,523,67,1426
E01015198,209,781,569,96,1655
E01015199,121,606,530,119,1376
E01015200,188,541,261,41,1031
E01015201,161,700,389,78,1328
E01015202,337,916,247,33,1533
E01015203,223,667,351,64,1305
E01015204,281,851,258,24,1414
E01015205,249,805,326,39,1419
E01015206,290,853,285,74,1502
E01015207,328,997,274,41,1640
E01015208,201,929,679,110,1919
E01015209,217,838,324,65,1444
E01015210,355,969,222,41,1587
E01015211,334,802,329,36,1501
E01015212,306,869,201,14,1390
E01015213,364,922,199,35,1520
E01015214,321,892,126,27,1366
E01015215,289,923,230,23,1465
E01015216,277,924,229,21,1451
E01015217,303,1150,197,26,1676
E01015218,282,868,275,60,1485
E01015219,140,670,427,72,1309
E01015220,181,781,383,41,1386
E01015221,210,817,352,50,1429
E01015222,242,899,436,51,1628
E01015223,236,788,262,16,1302
E01015224,270,889,311,63,1533
E01015225,221,849,302,94,1466
E01015226,189,707,422,36,1354
E01015227,282,908,343,80,1613
E01015228,251,826,375,91,1543
E01015229,194,702,387,148,1431
E01015230,170,686,471,68,1395
E01015231,326,1100,225,52,1703
E01015232,177,1152,424,76,1829
E01015233,201,861,278,64,1404
E01015234,296,907,204,18,1425
E01015235,115,816,629,153,1713
E01015236,245,925,376,44,1590
E01015237,283,841,208,27,1359
E01015238,259,783,296,53,1391
E01015239,189,752,435,158,1534
E01015240,155,699,536,176,1566
E01015241,251,858,314,78,1501
E01015242,319,831,178,20,1348
E01015243,157,687,378,49,1271
E01015244,221,763,414,38,1436
E01015245,187,682,387,56,1312
E01015246,220,710,406,132,1468
E01015247,349,1036,426,53,1864
E01015248,243,857,287,42,1429
E01015249,346,930,229,42,1547
E01015250,342,918,232,41,1533
E01015251,188,729,216,35,1168
E01015252,699,1806,360,33,2898
E01015253,454,1226,190,10,1880
E01015254,200,758,356,57,1371
E01015255,252,1190,192,73,1707
E01015256,206,1289,322,50,1867
E01015257,270,814,212,19,1315
E01015258,383,1356,398,25,2162
E01015259,326,876,142,16,1360
E01015260,251,994,263,35,1543
E01015261,363,1348,329,50,2090
E01015262,257,827,236,29,1349
E01015263,430,916,204,29,1579
E01015264,163,683,406,48,1300
E01015265,206,722,457,56,1441
E01015266,335,881,232,30,1478
E01015267,122,884,398,102,1506
E01015268,104,787,522,115,1528
E01015269,168,869,477,118,1632
E01015270,94,847,549,88,1578
E01015271,116,649,557,107,1429
E01019886,569,1747,679,66,3061
E01019887,303,933,314,78,1628
E01019888,144,863,477,116,1600
E01019889,295,892,456,86,1729
E01019890,275,986,503,78,1842
E01019891,255,903,313,45,1516
E01019892,1527,3103,370,58,5058
E01019893,685,1741,392,51,2869
E01019894,112,528,636,149,1425
E01019895,183,673,535,123,1514
E01019896,147,600,667,147,1561
E01019897,322,882,319,48,1571
E01019898,368,1260,728,98,2454
E01019899,212,737,358,68,1375
E01019900,239,803,675,141,1858
E01019901,186,715,405,28,1334
E01019902,304,1134,587,106,2131
E01019903,344,1262,470,83,2159
E01019904,269,812,348,31,1460
E01019905,274,1131,425,80,1910
E01019906,256,870,343,44,1513
E01019907,200,777,471,53,1501
E01019908,443,1163,191,23,1820
E01019909,263,918,571,103,1855
E01019910,327,924,397,48,1696
E01019911,149,687,593,122,1551
E01019912,173,826,506,133,1638
E01019913,116,584,738,323,1761
E01019914,436,1266,461,84,2247
E01019915,242,818,555,159,1774
E01019916,428,1459,269,51,2207
E01019917,279,967,216,56,1518
E01019918,189,1320,362,59,1930
E01019919,307,1080,247,41,1675
E01019920,280,1034,260,32,1606
E01019921,294,883,306,60,1543
E01019922,274,844,316,53,1487
E01019923,230,726,262,22,1240
E01019924,311,957,217,21,1506
E01019925,258,775,240,25,1298
E01019927,243,702,257,80,1282
E01019928,258,866,234,48,1406
E01019929,258,856,248,41,1403
E01019930,213,749,369,71,1402
E01019931,166,676,326,63,1231
E01019932,231,962,408,62,1663
E01019933,195,707,316,84,1302
E01019934,209,933,572,113,1827
E01019935,173,653,439,59,1324
E01019936,163,556,342,56,1117
E01019937,334,1151,610,85,2180
E01019938,361,1208,630,58,2257
E01019939,269,797,461,54,1581
E01019940,230,753,505,83,1571
E01019942,327,1052,363,82,1824
E01019943,349,900,407,46,1702
E01019944,371,1009,309,47,1736
E01019945,341,1368,484,77,2270
E01019946,128,547,611,154,1440
E01019947,212,978,599,190,1979
E01019948,146,566,504,87,1303
E01019949,171,637,524,124,1456
E01019950,127,546,449,63,1185
E01019951,237,987,798,144,2166
E01019952,237,841,557,139,1774
E01019953,183,692,555,116,1546
E01019954,399,1160,402,74,2035
E01019955,249,784,476,86,1595
E01019956,154,742,502,208,1606
E01019957,85,641,843,278,1847
E01019958,210,786,623,133,1752
E01019959,218,655,292,42,1207
E01019960,296,752,317,25,1390
E01019961,381,1461,699,102,2643
E01019962,393,1449,512,64,2418
E01019963,344,922,367,58,1691
E01019964,200,1758,248,40,2246
E01019965,366,973,382,61,1782
E01019966,141,552,342,50,1085
E01019967,203,698,385,42,1328
E01019968,248,836,408,79,1571
E01019969,227,861,219,42,1349
E01019970,237,825,234,64,1360
E01019971,196,1252,211,51,1710
E01019972,291,1006,120,27,1444
E01019973,260,879,290,63,1492
E01019974,204,811,297,41,1353
E01019975,350,853,142,21,1366
E01019976,220,797,358,111,1486
E01019977,282,910,268,51,1511
E01019980,416,1188,150,7,1761
E01019981,295,906,213,26,1440
E01019982,330,1230,120,16,1696
E01019983,236,854,360,11,1461
E01019984,250,921,183,15,1369
E01019985,329,943,126,16,1414
E01019986,276,963,251,44,1534
E01019987,224,1370,223,47,1864
E01019988,233,892,214,86,1425
E01019989,201,846,132,44,1223
E01019990,345,890,151,17,1403
E01019991,409,995,151,29,1584
E01019992,273,1032,241,67,1613
E01019993,172,805,175,25,1177
E01019994,153,1201,170,20,1544
E01019995,183,1760,206,42,2191
E01019996,107,957,151,114,1329
E01019997,89,1292,91,17,1489
E01019998,259,844,233,51,1387
E01019999,170,791,195,49,1205
E01020000,243,842,207,34,1326
E01020001,153,784,319,26,1282
E01020002,476,1278,287,98,2139
E01020003,273,940,421,74,1708
E01020004,233,1000,303,70,1606
E01020005,407,1119,254,44,1824
E01020006,445,1555,208,26,2234
E01020007,127,1268,42,7,1444
E01020008,191,1578,72,17,1858
E01020009,225,961,145,46,1377
E01020010,463,1256,226,28,1973
E01020011,202,746,301,42,1291
E01020012,347,1059,225,37,1668
E01020013,199,996,191,27,1413
E01020014,315,1003,175,10,1503
E01020015,438,1227,239,59,1963
E01020016,195,1953,251,40,2439
E01020017,311,2462,114,45,2932
E01020018,103,1746,270,52,2171
E01020019,75,1602,209,139,2025
E01020020,119,1517,90,16,1742
E01020021,160,1631,139,29,1959
E01020022,132,2065,92,16,2305
E01020023,442,1415,337,69,2263
E01020024,258,904,285,75,1522
E01020025,241,1068,159,24,1492
E01020026,239,1024,412,41,1716
E01020027,309,1057,298,29,1693
E01020029,258,1163,205,33,1659
E01020030,333,1403,182,86,2004
E01020031,356,1116,165,28,1665
E01020032,232,1090,238,34,1594
E01020033,495,1186,489,101,2271
E01020035,708,1927,376,23,3034
E01020036,271,878,247,82,1478
E01020037,311,845,209,41,1406
E01020038,397,1295,288,41,2021
E01020039,370,1184,336,58,1948
E01020040,225,793,232,39,1289
E01020041,539,1469,323,50,2381
E01020042,245,862,380,78,1565
E01020043,458,1190,379,45,2072
E01020044,261,932,394,61,1648
E01020045,279,920,388,56,1643
E01020046,248,944,330,32,1554
E01020047,302,1114,568,126,2110
E01020048,430,1425,324,62,2241
E01020049,209,767,375,54,1405
E01020050,285,1149,624,95,2153
E01020051,201,885,567,96,1749
E01020052,323,1191,327,59,1900
E01020053,297,808,279,30,1414
E01020054,528,1443,343,52,2366
E01020055,316,1110,350,105,1881
E01020056,379,1371,407,66,2223
E01020057,502,1441,318,45,2306
E01020058,328,1198,381,52,1959
E01020059,441,1326,378,51,2196
E01020060,243,983,370,126,1722
E01020061,434,1253,399,82,2168
E01020062,213,932,356,63,1564
E01020063,460,1359,506,92,2417
E01020064,400,1076,303,49,1828
E01020065,537,1299,251,44,2131
E01020066,628,1892,443,62,3025
E01020067,539,1199,217,30,1985
E01020068,242,862,363,63,1530
E01020069,253,885,320,45,1503
E01020070,297,1083,426,70,1876
E01020071,330,1085,462,75,1952
E01020072,284,999,386,56,1725
E01020073,267,922,439,58,1686
E01020074,390,1293,476,58,2217
E01020075,386,1145,410,59,2000
E01020076,325,1060,330,38,1753
E01020077,307,1024,339,36,1706
E01020078,255,840,223,47,1365
E01020079,265,737,273,53,1328
E01020080,255,792,345,54,1446
E01020081,222,736,334,22,1314
E01020082,174,689,289,28,1180
E01020083,482,1455,470,29,2436
E01020084,230,815,341,55,1441
E01020085,326,978,203,28,1535
E01020086,286,906,408,51,1651
E01020087,274,1133,606,69,2082
E01020088,325,1204,467,67,2063
E01020089,500,1409,426,81,2416
E01020090,308,975,467,88,1838
E01020091,192,721,335,43,1291
E01020092,191,706,431,117,1445
E01020093,233,786,323,56,1398
E01020094,206,1082,343,94,1725
E01020095,339,966,180,41,1526
E01020096,252,1073,307,79,1711
E01020097,327,1301,572,51,2251
E01020098,309,1210,582,86,2187
E01020099,181,722,407,39,1349
E01020100,172,565,314,32,1083
E01020101,233,796,361,61,1451
E01020102,335,1101,191,48,1675
E01020103,442,994,182,24,1642
E01020104,373,903,104,5,1385
E01020105,420,1065,389,58,1932
E01020106,125,505,398,68,1096
E01020107,213,780,499,131,1623
E01020108,375,1268,506,56,2205
E01020109,259,774,292,45,1370
E01020110,587,1792,357,70,2806
E01020111,294,828,210,30,1362
E01020112,217,1004,283,54,1558
E01020113,279,916,280,68,1543
E01020114,217,749,246,29,1241
E01020115,206,708,304,29,1247
E01020116,281,940,321,51,1593
E01020117,209,826,403,54,1492
E01020118,291,831,215,33,1370
E01020119,182,790,428,62,1462
E01020120,351,1095,375,75,1896
E01020121,404,1200,411,53,2068
E01020122,286,1088,398,43,1815
E01020123,305,823,345,47,1520
E01020124,184,737,371,82,1374
E01020125,202,683,459,49,1393
E01020126,140,978,435,82,1635
E01020127,366,1164,454,39,2023
E01020128,270,854,340,82,1546
E01020129,216,717,245,20,1198
E01020130,285,992,187,27,1491
E01020131,416,1346,457,53,2272
E01020132,263,986,402,85,1736
E01020133,241,856,312,23,1432
E01020134,257,744,191,46,1238
E01020135,277,817,317,98,1509
E01020136,322,1050,401,66,1839
E01020137,238,998,327,95,1658
E01020138,370,1372,561,94,2397
E01020139,265,828,266,39,1398
E01020140,176,603,322,46,1147
E01020141,460,1133,206,11,1810
E01020142,556,1542,528,83,2709
E01020143,402,1454,494,35,2385
E01020144,250,1021,150,14,1435
E01020145,279,1415,448,31,2173
E01020146,214,773,166,26,1179
E01020147,230,1041,539,65,1875
E01020148,165,666,273,22,1126
E01020149,243,775,288,31,1337
E01020150,287,1029,457,116,1889
E01020151,121,712,586,90,1509
E01020152,108,718,447,94,1367
E01020153,116,600,400,30,1146
E01020154,264,1084,163,17,1528
E01020155,211,650,210,40,1111
E01020156,326,1114,569,73,2082
E01020157,389,1374,594,60,2417
E01020158,268,1014,380,52,1714
E01020159,288,836,313,45,1482
E01020160,317,1199,395,28,1939
E01020161,399,1339,533,143,2414
E01020162,338,1034,233,13,1618
E01020163,368,1139,277,35,1819
E01020164,252,900,275,26,1453
E01020165,344,1030,218,28,1620
E01020166,262,864,304,47,1477
E01020167,279,844,175,28,1326
E01020168,323,1066,589,138,2116
E01020169,367,1358,406,87,2218
E01020170,314,1196,617,74,2201
E01020171,223,921,633,87,1864
E01020172,262,964,524,75,1825
E01020173,132,687,451,77,1347
E01020174,209,765,506,66,1546
E01020175,254,965,729,83,2031
E01020176,145,604,273,66,1088
E01020177,260,769,345,100,1474
E01020178,285,962,674,88,2009
E01020179,240,1015,636,86,1977
E01020180,370,1166,405,58,1999
E01020181,262,971,428,71,1732
E01020182,306,1047,240,35,1628
E01020183,179,810,380,95,1464
E01020184,227,1001,392,53,1673
E01020185,183,691,425,42,1341
E01020186,159,637,576,59,1431
E01020187,354,1039,366,62,1821
E01020188,293,1048,517,56,1914
E01020189,348,1178,502,99,2127
E01020190,448,1242,617,77,2384
E01020191,259,1513,264,47,2083
E01020192,184,802,438,68,1492
E01020193,256,929,300,41,1526
E01020194,282,950,278,30,1540
E01020195,362,1101,351,58,1872
E01020196,273,986,366,70,1695
E01020197,175,674,382,35,1266
E01020198,271,864,251,18,1404
E01020199,316,1033,322,52,1723
E01020200,110,564,359,44,1077
E01020201,175,672,587,124,1558
E01020202,275,862,601,111,1849
E01020203,227,754,567,130,1678
E01020204,361,1032,166,40,1599
E01020205,195,830,407,92,1524
E01020206,261,902,296,49,1508
E01020207,586,1485,265,117,2453
E01020208,244,808,220,41,1313
E01020209,289,871,259,13,1432
E01020210,158,686,338,45,1227
E01020211,342,980,228,25,1575
E01020212,256,773,192,25,1246
E01020213,237,859,347,40,1483
E01020214,226,872,393,61,1552
E01020215,158,708,384,48,1298
E01020216,323,1012,207,40,1582
E01020217,294,994,342,86,1716
E01020218,278,1109,206,51,1644
E01020219,416,1423,301,22,2162
E01020220,373,983,269,40,1665
E01020221,300,1101,347,37,1785
E01020222,231,734,245,29,1239
E01020223,281,1046,409,32,1768
E01020224,272,811,147,16,1246
E01020225,259,947,173,29,1408
E01020226,202,722,372,130,1426
E01020227,193,792,306,90,1381
E01020228,183,906,526,136,1751
E01020229,462,1562,710,88,2822
E01020230,276,1010,409,58,1753
E01020231,206,889,387,57,1539
E01020232,398,1163,315,21,1897
E01020233,174,786,651,103,1714
E01020234,286,869,268,47,1470
E01020235,231,919,483,111,1744
E01020236,149,700,354,34,1237
E01020237,257,906,339,51,1553
E01020238,217,676,308,57,1258
E01020239,201,623,369,70,1263
E01020240,297,943,325,104,1669
E01020241,285,1122,303,40,1750
E01020242,466,1293,331,29,2119
E01020243,201,693,266,37,1197
E01020244,235,773,318,57,1383
E01020245,222,940,345,60,1567
E01020246,182,768,230,26,1206
E01020247,312,925,348,73,1658
E01020248,249,986,481,50,1766
E01020249,140,763,382,56,1341
E01020250,232,888,414,73,1607
E01020251,238,923,294,46,1501
E01020252,306,992,240,85,1623
E01020253,280,1002,203,26,1511
E01020254,277,815,212,47,1351
E01020255,206,755,334,34,1329
E01020256,269,878,281,56,1484
E01020257,175,712,266,41,1194
E01020258,244,1033,411,83,1771
E01020259,137,667,305,44,1153
E01020260,163,566,436,90,1255
E01020261,162,636,348,47,1193
E01020262,156,742,358,83,1339
E01020263,185,759,554,86,1584
E01020264,173,845,360,150,1528
E01020265,269,937,440,55,1701
E01020266,251,922,386,44,1603
E01020267,210,860,406,58,1534
E01020268,305,874,551,130,1860
E01020269,112,1009,523,139,1783
E01020270,305,1004,384,37,1730
E01020271,295,996,262,64,1617
E01020272,438,1127,234,40,1839
E01020273,249,825,352,39,1465
E01020274,197,732,287,14,1230
E01020275,135,758,329,34,1256
E01020276,225,804,430,56,1515
E01020277,460,1271,377,45,2153
E01020278,298,995,328,26,1647
E01020279,663,1746,443,29,2881
E01020280,375,1485,322,42,2224
E01020281,347,1267,420,54,2088
E01020282,331,874,375,75,1655
E01020283,329,1068,483,74,1954
E01020284,454,1280,271,40,2045
E01020285,479,1290,239,41,2049
E01020286,263,1023,388,47,1721
E01020287,226,891,421,54,1592
E01020288,237,969,413,42,1661
E01020289,200,860,482,32,1574
E01020290,236,933,512,68,1749
E01020291,277,945,384,36,1642
E01020292,229,910,383,58,1580
E01020293,378,1431,537,57,2403
E01020294,431,1158,488,118,2195
E01020295,278,866,426,118,1688
E01020296,227,892,461,39,1619
E01020297,277,808,378,50,1513
E01020298,268,1017,694,103,2082
E01020299,218,990,587,93,1888
E01020300,210,946,591,164,1911
E01020301,353,1191,456,45,2045
E01020302,307,1034,467,58,1866
E01020303,186,907,466,49,1608
E01020304,308,1031,378,53,1770
E01020305,172,682,229,48,1131
E01020306,275,792,258,40,1365
E01020307,356,955,331,55,1697
E01020308,252,1109,438,48,1847
E01020309,274,1086,399,43,1802
E01020310,206,1110,790,110,2216
E01020311,351,1184,598,56,2189
E01020312,168,796,539,47,1550
E01020313,269,863,267,51,1450
E01020314,242,982,431,64,1719
E01020315,247,803,374,95,1519
E01020316,263,1031,514,60,1868
E01020317,182,738,410,66,1396
E01020318,215,820,451,53,1539
E01020319,223,947,415,33,1618
E01020320,239,967,511,66,1783
E01020321,389,1407,460,95,2351
E01020322,578,1663,606,88,2935
E01020323,279,1432,393,37,2141
E01020324,164,868,434,73,1539
E01020325,254,946,344,39,1583
E01020326,381,1300,424,70,2175
E01020327,291,939,375,70,1675
E01020328,547,1444,314,41,2346
E01020329,215,925,414,64,1618
E01020330,307,990,426,97,1820
E01020331,229,879,442,66,1616
E01020332,265,1106,370,88,1829
E01020333,355,1047,456,61,1919
E01020334,350,1129,384,60,1923
E01020335,226,796,481,128,1631
E01020336,149,618,497,69,1333
E01020337,293,803,293,51,1440
E01020338,497,1411,463,58,2429
E01020339,273,956,413,44,1686
E01020340,289,1034,393,30,1746
E01020341,219,792,521,74,1606
E01020342,285,960,277,24,1546
E01032628,390,1270,531,101,2292
E01032657,137,1108,192,42,1479
E01032658,134,1265,186,36,1621
E01033232,364,1147,79,18,1608
E01033233,272,6309,572,142,7295
E01033234,333,1136,228,15,1712
E01033235,133,648,377,97,1255
E01033236,146,490,343,79,1058
E07000040,22629,76878,35976,6782,142265
E07000041,19990,88376,17120,3430,128916
E07000042,14759,47145,16165,2554,80623
E07000043,16483,55186,20463,3308,95440
E07000044,13419,48269,20646,3006,85340
E07000045,21363,75898,29174,5002,131437
E07000046,11091,38558,15972,2200,67821
E07000047,8883,31392,13092,1962,55329
E10000008,128617,461702,168608,28244,787171
E06000026,47120,168264,41310,6376,263070
E06000027,22680,77216,30308,5043,135247
IMDQ1,29668,102233,22802,3702,158405
IMDQ2,49677,175686,53364,8867,287594
IMDQ3,53759,198609,70127,10802,333297
IMDQ4,43748,147768,57697,9956,259169
IMDQ5,21565,82886,36236,6336,147023
E02003122,1125,3924,1793,263,7105
E02003123,1666,5072,1471,186,8395
E02003124,1731,4834,1128,182,7875
E02003125,1033,3811,1106,144,6094
E02003126,1287,4632,1454,170,7543
E02003127,1698,4643,1174,149,7664
E02003128,1782,5414,1444,223,8863
E02003129,1273,3589,1297,202,6361
E02003130,2233,6655,1606,208,10702
E02003131,1437,4427,1461,147,7472
E02003132,1834,5503,1395,238,8970
E02003133,1313,4405,1452,167,7337
E02003134,1467,4345,983,119,6914
E02003135,1920,5419,793,70,8202
E02003136,1246,4246,1998,379,7869
E02003137,1406,4581,1573,430,7990
E02003138,1462,5197,890,136,7685
E02003139,1368,4126,819,54,6367
E02003140,1458,4493,1493,265,7709
E02003141,1278,5568,956,153,7955
E02003142,1785,5937,1348,194,9264
E02003143,1376,4596,1359,198,7529
E02003144,634,7383,633,158,8808
E02003145,1092,4707,1017,203,7019
E02003146,1318,6875,716,119,9028
E02003147,2113,5950,920,92,9075
E02003148,949,8174,1005,131,10259
E02003149,1594,7046,816,130,9586
E02003150,1807,8704,1507,268,12286
E02003151,1114,3802,2074,444,7434
E02003152,1914,5826,2099,297,10136
E02003153,1407,4380,1530,257,7574
E02003154,1391,4029,1535,192,7147
E02003155,976,3301,1315,282,5874
E02003156,2229,6367,1583,218,10397
E02003157,1230,4040,1015,95,6380
E02003158,882,3075,1406,323,5686
E02003159,1169,3607,860,131,5767
E02003161,1124,4977,1040,199,7340
E02003163,604,4036,2503,530,7673
E02003164,1383,4865,2224,432,8904
E02003165,1380,4092,1467,234,7173
E02003166,2614,6749,1986,204,11553
E02003167,1309,5538,2147,511,9505
E02003168,1009,3955,1860,230,7054
E02003169,833,3310,2272,401,6816
E02003170,1222,4901,2947,398,9468
E02003171,1220,4048,1920,321,7509
E02004129,868,3040,1602,206,5716
E02004130,878,3304,1553,339,6074
E02004131,895,3147,1177,223,5442
E02004132,1555,4901,1892,257,8605
E02004133,1452,4987,2268,396,9103
E02004134,2811,7009,1545,237,11602
E02004135,1168,4210,2513,426,8317
E02004136,1546,4511,2045,312,8414
E02004137,698,2688,1706,250,5342
E02004138,784,3274,2687,618,7363
E02004139,1068,3477,1990,415,6950
E02004140,449,2169,1968,619,5205
E02004141,1019,3441,1461,220,6141
E02004142,934,3991,1358,199,6482
E02004143,999,3590,1587,208,6384
E02004144,1182,3692,1752,296,6922
E02004145,764,2683,2157,467,6071
E02004146,1389,4444,1361,188,7382
E02004147,1203,4826,1094,207,7330
E02004148,967,3494,2260,699,7420
E02004149,854,8728,1319,268,11169
E02004150,1296,4800,726,112,6934
E02004151,1662,5369,1506,353,8890
E02004152,575,8107,621,217,9520
E02004153,1561,5136,939,65,7701
E02004154,1286,6310,780,180,8556
E02004155,1453,4663,1275,264,7655
E02004156,945,9122,1011,199,11277
E02004157,1048,4344,932,282,6606
E02004158,1529,5625,932,202,8288
E02004159,2350,7586,1681,167,11784
E02004160,1261,4303,1426,292,7282
E02004161,1648,5374,1045,210,8277
E02004162,1199,4780,1192,263,7434
E02004163,1323,4129,1735,356,7543
E02004164,1049,3884,1668,217,6818
E02004165,1386,4683,1923,338,8330
E02004166,1236,3797,1392,209,6634
E02004167,1696,4497,1074,163,7430
E02004168,1172,3738,1154,184,6248
E02004169,1333,4254,1425,219,7231
E02004170,1674,5192,1392,254,8512
E02004171,1428,4578,1642,247,7895
E02004172,1050,3670,1444,180,6344
E02004173,1274,4285,1579,207,7345
E02004174,1461,4567,1472,336,7836
E02004175,934,3289,1043,142,5408
E02004176,726,3061,1517,214,5518
E02004177,1060,3513,1219,206,5998
E02004178,942,3017,1265,189,5413
E02004179,1703,5414,1872,367,9356
E02004180,1042,3463,1296,181,5982
E02004181,1026,3414,1171,193,5804
E02004182,1181,3784,1051,192,6208
E02004183,943,3316,1482,257,5998
E02004184,1921,5561,1249,206,8937
E02004185,940,3140,1714,319,6113
E02004186,1532,4987,1761,230,8510
E02004187,1580,5512,2074,363,9529
E02004188,953,3715,1749,249,6666
E02004189,986,3984,1052,102,6124
E02004190,1276,4612,1880,276,8044
E02004191,1344,4995,1845,312,8496
E02004192,1049,3958,2103,233,7343
E02004193,2242,7150,2015,320,11727
E02004194,1245,4025,1479,234,6983
E02004195,704,3164,1406,241,5515
E02004196,1234,4133,1849,239,7455
E02004197,919,3288,2000,250,6457
E02004198,1038,3602,1497,324,6461
E02004199,748,2692,1909,237,5586
E02004200,634,2666,1611,238,5149
E02004201,739,2926,1465,220,5350
E02004202,1505,5071,1622,290,8488
E02004203,825,3355,1475,258,5913
E02004204,1673,5520,2133,317,9643
E02004205,1342,4624,1821,224,8011
E02004206,874,3480,1928,397,6679
E02004207,1042,3500,1460,236,6238
E02004208,1340,4597,2167,324,8428
E02004209,1476,5164,1669,306,8615
E02004210,1018,3977,1379,393,6767
E02004211,848,3361,2024,351,6584
E02004212,1107,3788,1118,121,6134
E02004213,1396,4826,1088,250,7560
E02004214,1186,3894,923,178,6181
E02004215,977,3473,1058,289,5797
E02004216,877,3212,1316,174,5579
E02004217,1397,4658,1672,233,7960
E02004218,883,3442,1441,205,5971
E02004219,858,3030,1415,236,5539
E02004220,855,3360,1724,233,6172
E02004221,684,3073,2075,377,6209
E02004222,1053,3626,1117,171,5967
E02004223,2683,7650,2141,255,12729
E02004224,971,3637,1683,257,6548
E02004225,1111,3460,1196,196,5963
E02004226,1015,4091,1923,207,7236
E02004227,1667,5654,2275,312,9908
E02004228,1052,4007,1838,192,7089
E02004229,1587,5337,2001,319,9244
E02004230,1360,4298,1529,272,7459
E02004231,990,4155,1672,167,6984
E02004232,1014,3841,1610,199,6664
E02004233,2135,6910,2944,515,12504
E02004234,850,3358,1642,237,6087
E02004235,947,3493,1694,253,6387
E02006840,2105,6326,2228,342,11001
TOWN01,1397,4658,1672,233,7960
TOWN02,2372,8355,4133,655,15515
TOWN03,8403,26875,9296,1516,46090
TOWN04,6428,22136,9168,1355,39087
TOWN05,2270,7163,2631,500,12564
TOWN06,3785,12522,4495,723,21525
TOWN07,4656,14310,4546,711,24223
TOWN08,1367,5777,3052,410,10606
TOWN09,2451,8877,4067,678,16073
TOWN10,24296,101396,21483,4153,151328
TOWN11,7755,27750,11692,2301,49498
TOWN12,1775,6367,2521,347,11010
TOWN13,2719,9661,4113,504,16997
TOWN14,2842,10163,4644,796,18445
TOWN15,2955,10153,3850,536,17494
TOWN16,5863,20420,7584,961,34828
TOWN17,2722,9537,4816,799,17874
TOWN18,140,978,435,82,1635
TOWN19,630,2525,1068,166,4389
TOWN20,12267,42970,14957,2511,72705
TOWN21,4540,15558,6231,871,27200
TOWN22,3272,9746,3720,553,17291
TOWN23,1510,5800,4223,905,12438
TOWN24,2088,7784,5366,1263,16501
TOWN25,2163,7855,3262,518,13798
TOWN26,4694,17018,7459,1147,30318
TOWN27,2806,10376,4928,975,19085
TOWN28,6984,22437,8002,1239,38662
TOWN29,3467,12535,5194,836,22032
DIV1,2557,9131,2597,540,14825
DIV2,2194,8050,2514,351,13109
DIV3,1996,7004,3309,554,12863
DIV4,2459,8271,2529,464,13723
DIV5,2612,7804,2424,384,13224
DIV6,1847,7017,2692,287,11843
DIV7,2701,8530,2726,310,14267
DIV8,2006,6383,2215,373,10977
DIV9,1862,6653,3035,551,12101
DIV10,2270,7163,2631,500,12564
DIV11,3179,8269,2273,335,14056
DIV12,2060,7213,2874,360,12507
DIV13,1677,5894,2338,308,10217
DIV14,1792,6697,2944,376,11809
DIV15,2442,7771,2561,431,13205
DIV16,2241,7792,3129,464,13626
DIV17,2511,7753,2178,365,12807
DIV18,1753,7122,3509,474,12858
DIV19,2216,8104,3749,621,14690
DIV20,1257,11201,1665,331,14454
DIV21,1862,6506,2246,410,11024
DIV22,1731,6177,4417,1166,13491
DIV23,5683,20205,6791,1058,33737
DIV24,2797,9461,1681,231,14170
DIV25,2421,8496,3501,688,15106
DIV26,1782,5839,2666,453,10740
DIV27,2298,8060,3280,449,14087
DIV28,2508,9066,2132,482,14188
DIV29,2719,9661,4113,504,16997
DIV30,1994,6802,2262,348,11406
DIV31,1810,6745,3340,537,12432
DIV32,2242,7150,2015,320,11727
DIV33,1786,6294,3406,561,12047
DIV34,2268,8201,3190,576,14235
DIV35,2588,8388,2138,415,13529
DIV36,2145,7464,2542,464,12615
DIV37,1539,6433,3799,610,12381
DIV38,2374,8139,3139,471,14123
DIV39,2221,7030,3139,474,12864
DIV40,2588,8059,1983,424,13054
DIV41,1688,6263,3058,438,11447
DIV42,1696,6515,4628,933,13772
DIV43,1754,6633,4756,1178,14321
DIV44,2070,6945,3170,463,12648
DIV45,1897,6716,2669,475,11757
DIV46,1411,10342,1441,401,13595
DIV47,1739,14799,1325,346,18209
DIV48,2135,6910,2944,515,12504
DIV49,2358,8574,3546,717,15195
DIV50,2966,8600,2462,372,14400
DIV51,2223,7560,3066,513,13362
DIV52,2126,7551,3119,403,13199
DIV53,2033,7478,2796,463,12770
DIV54,2473,7471,2448,448,12840
DIV55,1948,6549,3162,396,12055
DIV56,2376,7669,2769,409,13223
DIV57,2660,8846,1848,227,13581
DIV58,2076,8283,3729,527,14615
CHSCTAXE,5970,21939,13722,2823,44454
CHSCTBARNSTAPLE,6803,21826,7058,1125,36812
CHSCTBIDEFORD,7562,25306,10610,1646,45124
CHSCTBRAUNTON,5365,18294,6916,1118,31693
CHSCTCREDITON,3629,12223,4599,714,21165
CHSCTCULLOMPTON,5846,18492,6185,975,31498
CHSCTDAWLISH,5009,18444,8438,1519,33410
CHSCTEXETERCHALL,13547,44356,11958,2109,71970
CHSCTEXETERSYCAMORE,10885,56630,8898,1938,78351
CHSCTEXMOUTH,7755,27750,11692,2301,49498
CHSCTHONITON,5429,18168,7972,1298,32867
CHSCTIVYBRIDGE,5927,20038,7932,1091,34988
CHSCTKINGSBRIDGE,2722,9537,4816,799,17874
CHSCTNABBOT,9531,33792,11573,1999,56895
CHSCTOKE,4783,17082,6573,969,29407
CHSCTSMOLTON,2781,9961,4299,632,17673
CHSCTTAVISTOCK,5447,19829,8223,1211,34710
CHSCTTEIGN,4652,15710,6219,942,27523
CHSCTTIVERTON,6690,21503,7572,1173,36938
CHSCTTORRINGTON,4960,17907,7430,951,31248
CHSCTTOTNES,3324,12915,5923,911,23073
Eastern,64015,235594,78351,14183,392143
Northern,27574,93744,36435,5508,163261
Southern,46229,161925,64440,10647,283241
Western,60599,215919,61000,9325,346843
